S....X....
.XXX.X..X.
...X....X.
.X....X.X.
.XXXXXXXX.
XX........
...XXX....
.XX....XXX
.XXXXXXX..
.........E